Abend	noche
Abend	tarde
Abfahrt	salida
Ankunft	llegada
Antworten	responder
Apfel	manzana
Apotheke	farmacia
Apotheke	farmacia
Arbeit	trabajo
Arbeiten	trabajar
Arm	brazo
Arzt	médico
Auge	ojo
Auto	coche
Auto	coche
Bahnhof	estación
Banane	plátano
Bank	banco
Baum	árbol
Bein	pierna
Berg	montaña
Bibliothek	biblioteca
Blume	flor
Blut	sangre
Brille	gafas
Brot	pan
Buch	libro
Buchhandlung	librería
Buchhandlung	librería
Bus	autobús
Bäckerei	panadería
Café	cafetería
Computer	ordenador
Diagnose	diagnóstico
Dorf	pueblo
Eintrittskarte	entrada
Elektronik	electrónica
Essen	comer
Fahren	conducir
Fahrer	conductor
Fahrerin	conductora
Fahrplan	horario
Fahrrad	bicicleta
Fahrrad	bicicleta
Fernseher	televisor
Feuerwehr	bomberos
Finden	encontrar
Finger	dedo
Fisch	pez
Fitnessstudio	gimnasio
Flughafen	aeropuerto
Flugzeug	avión
Flugzeug	avión
Fluss	río
Fragen	preguntar
Freund	amigo
Freundin	amiga
Freundschaft	amistad
Friseur	peluquería
Frühling	primavera
Fuß	pie
Galerie	galería
Garten	jardín
Gepäck	equipaje
Gerechtigkeit	justicia
Gesetz	ley
Gesundheit	salud
Hand	mano
Hassen	odiar
Haus	casa
Haut	piel
Herbst	otoño
Herz	corazón
Himmel	cielo
Hitze	calor
Hose	pantalones
Hotel	hotel
Hund	perro
Hören	escuchar
Impfung	vacuna
Insel	isla
Jahr	año
Kaffee	café
Kalender	calendario
Kamera	cámara
Karte	tarjeta
Katze	gato
Kaufen	comprar
Kino	cine
Kino	cine
Kleid	vestido
Kleidung	ropa
Knochen	hueso
Kochen	cocinar
Koffer	maleta
Kopf	cabeza
Kosmetik	cosméticos
Krankenhaus	hospital
Krankenschwester	enfermera
Kunst	arte
Kälte	frío
Käse	queso
Laufen	correr
Lebensmittel	alimentos
Lehrer	maestro
Lernen	aprender
Lesen	leer
Liebe	amor
Lieben	amar
Magen	estómago
Markt	mercado
Medizin	medicina
Meer	mar
Metzgerei	carnicería
Milch	leche
Minute	minuto
Minute	minuto
Mittag	mediodía
Monat	mes
Mond	luna
Morgen	mañana
Morgen	mañana
Mund	boca
Museum	museo
Museum	museo
Musik	música
Möbel	muebles
Nachmittag	tarde
Nacht	noche
Nase	nariz
Ohr	oído
Operation	operación
Orange	naranja
Park	parque
Passagier	pasajero
Patient	paciente
Pferd	caballo
Politik	política
Polizei	policía
Regen	lluvia
Regen	lluvia
Regierung	gobierno
Reise	viaje
Reise	viaje
Reisen	viajar
Reisepass	pasaporte
Reiseziel	destino
Restaurant	restaurante
Restaurant	restaurante
Rezept	receta
Rucksack	mochila
Schiff	barco
Schlafen	dormir
Schmuck	joyería
Schnee	nieve
Schnee	nieve
Schreiben	escribir
Schuhe	zapatos
Schule	escuela
Schwimmbad	piscina
Schüler	estudiante
See	lago
Sehen	ver
Sekunde	segundo
Sekunde	segundo
Singen	cantar
Sommer	verano
Sonne	sol
Sonne	sol
Souvenir	recuerdo
Spielzeug	juguetes
Sport	deporte
Sprechen	hablar
Springen	saltar
Stadt	ciudad
Stern	estrella
Stift	bolígrafo
Strand	playa
Strand	playa
Straße	calle
Strecke	ruta
Studieren	estudiar
Stunde	hora
Sturm	tormenta
Supermarkt	supermercado
Supermarkt	supermercado
Tablette	pastilla
Tag	día
Tanz	danza
Tanzen	bailar
Taxi	taxi
Tee	té
Telefon	teléfono
Theater	teatro
Theater	teatro
Therapie	terapia
Ticket	billete
Tier	animal
Tourist	turista
Trinken	beber
Uhr	reloj
Uhr	reloj
Universität	universidad
Unterkunft	alojamiento
Unterrichten	enseñar
Urlaub	vacaciones
Verkaufen	vender
Verlieren	perder
Visum	visa
Vogel	pájaro
Wald	bosque
Wasser	agua
Werkstatt	taller
Wetter	clima
Wind	viento
Winter	invierno
Wirtschaft	economía
Woche	semana
Wohnen	vivir
Wolke	nube
Wolke	nube
Zahnarzt	dentista
Zeit	tiempo
Zeit	tiempo
Zoo	zoológico
Zug	tren
Zug	tren
Zunge	lengua