brief	long
cheap	expensive
dim	bright
empty	full
few	many
light	heavy
low	high
minimal	immense
minor	major
modest	extravagant
narrow	wide
near	far
quiet	loud
shallow	deep
short	tall
slow	fast
small	big
sparse	dense
subtle	blatant
thin	thick
tiny	huge
trickle	flood
trivial	crucial
whisper	shout
young	old