ant	black
apple	red
blackboard	black
blood	red
blueberry	blue
broccoli	green
bruise	blue
cabbage	green
carrot	orange
cauliflower	white
celery	green
cherry	red
chocolate	brown
cloud	gray
coal	black
coffee	black
cranberry	red
cream	white
crow	black
cucumber	green
emerald	green
fridge	white
frog	green
grapes	black
grass	green
leaves	green
milk	white
paper	white
parsley	green
peony	pink
pepper	black
potato	brown
radish	red
raven	black
rose	red
ruby	red
salt	white
sapphire	blue
sea	blue
sky	blue
snow	white
soil	brown
spinach	green
sugar	white
sun	yellow
swan	white
tea	black
tomato	red
toothpaste	white
yoghurt	white